#############################
#############################
##           ###           ##
## ### ##### ### ##### ### ##
## ### ##### ### ##### ### ##
##                         ##
## ### ## ######### ## ### ##
## ### ## ######### ## ### ##
##     ##     ##     ##    ##
###### ###### ## ##### ######
###### ###### ## ##### ######
###### ##              ######
###### ## ###---### ## ######
###### ## ##     ## ## ######
###### ## ##     ## ## ######
O      ## ##     ## ##      O
###### ## ##     ## ## ######
###### ## ##     ## ## ######
###### ## ######### ## ######
###### ##              ######
###### ###### ## ##### ######
###### ###### ## ##### ######
##     ##     ##     ##    ##
## ### ## ######### ## ### ##
## ### ## ######### ## ### ##
##                         ##
## ### ##### ### ##### ### ##
## ### ##### ### ##### ### ##
##           ###           ##
#############################
#############################
